player_id,name,pos,ppr_rank,avg_draft_pos,pos_diff,ppr_auc_value,avg_auc_value,auc_diff
3117251,Christian McCaffrey,RB,1,1,0,62,72,10
3116593,Dalvin Cook,RB,2,2,0,59,67,8
3054850,Alvin Kamara,RB,3,4,1,59,65,6
3929630,Saquon Barkley,RB,4,7,3,58,57,-1
3043078,Derrick Henry,RB,5,4,-1,56,65,9
15847,Travis Kelce,TE,6,8,2,53,55,2
16800,Davante Adams,WR,7,7,0,51,56,5
3051392,Ezekiel Elliott,RB,8,8,0,50,55,5
4242335,Jonathan Taylor,RB,9,12,3,48,49,1
3068267,Austin Ekeler,RB,10,14,4,46,48,2
3042519,Aaron Jones,RB,11,12,1,45,51,6
3128720,Nick Chubb,RB,12,12,0,45,50,5
3116406,Tyreek Hill,WR,13,11,-2,44,52,8
4360294,Antonio Gibson,RB,14,18,4,43,43,0
4241457,Najee Harris,RB,15,17,2,42,46,4
2976212,Stefon Diggs,WR,16,16,0,40,45,5
15795,DeAndre Hopkins,WR,17,18,1,38,41,3
3925357,Calvin Ridley,WR,18,20,2,37,39,2
4047650,DK Metcalf,WR,19,18,-1,36,40,4
4047646,A.J. Brown,WR,20,25,5,35,33,-2
4262921,Justin Jefferson,WR,21,25,4,34,35,1
3116385,Joe Mixon,RB,22,25,3,33,35,2
4242214,Clyde Edwards-Helaire,RB,23,29,6,32,33,1
2576925,Darren Waller,TE,24,25,1,32,33,1
3121422,Terry McLaurin,WR,25,29,4,31,29,-2
15818,Keenan Allen,WR,26,29,3,30,29,-1
16799,Allen Robinson II,WR,27,34,7,30,26,-4
4241389,CeeDee Lamb,WR,28,35,7,29,27,-2
3040151,George Kittle,TE,29,28,-1,28,30,2
4035538,David Montgomery,RB,30,35,5,26,25,-1
4052042,James Robinson,RB,31,33,2,26,26,0
4045163,Miles Sanders,RB,32,38,6,25,23,-2
15880,Robert Woods,WR,33,39,6,24,21,-3
16737,Mike Evans,WR,34,34,0,23,23,0
2976499,Amari Cooper,WR,35,41,6,22,20,-2
4259545,D'Andre Swift,RB,36,48,12,22,18,-4
3919596,Chris Carson,RB,37,41,4,22,23,1
16460,Adam Thielen,WR,38,46,8,21,18,-3
2577327,Tyler Lockett,WR,39,48,9,21,17,-4
3116165,Chris Godwin,WR,40,47,7,20,18,-2
2977187,Cooper Kupp,WR,41,49,8,19,17,-2
3932905,Diontae Johnson,WR,42,56,14,19,13,-6
13982,Julio Jones,WR,43,50,7,18,17,-1
3915416,DJ Moore,WR,44,57,13,17,13,-4
4360438,Brandon Aiyuk,WR,45,64,19,17,11,-6
4239993,Tee Higgins,WR,46,65,19,15,10,-5
4047365,Josh Jacobs,RB,47,42,-5,15,20,5
3119195,Chase Edmonds,RB,48,62,14,14,11,-3
3139477,Patrick Mahomes,QB,49,19,-30,13,34,21
3918298,Josh Allen,QB,51,30,-21,13,23,10
3051926,Gus Edwards,RB,53,70,17,12,13,1
4361579,Javonte Williams,RB,54,70,16,11,9,-2
3059915,Kareem Hunt,RB,55,62,7,11,11,0
3886818,Myles Gaskin,RB,56,68,12,10,10,0
2974858,Kenny Golladay,WR,57,76,19,10,7,-3
16733,Odell Beckham Jr.,WR,58,70,12,10,9,-1
2574808,Robby Anderson,WR,59,76,17,10,6,-4
3120348,JuJu Smith-Schuster,WR,60,71,11,9,7,-2
3128429,Courtland Sutton,WR,61,82,21,9,6,-3
3116365,Mark Andrews,TE,63,48,-15,9,11,2
4036133,T.J. Hockenson,TE,64,62,-2,8,8,0
4360248,Kyle Pitts,TE,65,52,-13,8,13,5
3917315,Kyler Murray,QB,66,41,-25,8,16,8
4241463,Jerry Jeudy,WR,68,75,7,7,7,0
4046692,Chase Claypool,WR,70,76,6,7,6,-1
16731,Brandin Cooks,WR,71,89,18,7,4,-3
2577417,Dak Prescott,QB,72,58,-14,7,10,3
3916387,Lamar Jackson,QB,74,46,-28,6,14,8
3025433,Mike Davis,RB,76,73,-3,6,9,3
4039359,Darrell Henderson Jr.,RB,77,92,15,6,5,-1
4362628,Ja'Marr Chase,WR,78,84,6,6,5,-1
3052876,William Fuller V,WR,79,97,18,6,3,-3
3045144,Tyler Boyd,WR,80,96,16,6,3,-3
4243160,Laviska Shenault Jr.,WR,81,97,16,5,3,-2
4036348,Michael Gallup,WR,84,99,15,5,2,-3
16813,Logan Thomas,TE,85,72,-13,5,5,0
4241478,DeVonta Smith,WR,86,93,7,5,4,-1
3126486,Deebo Samuel,WR,87,102,15,4,3,-1
8439,Aaron Rodgers,QB,88,49,-39,4,12,8
14881,Russell Wilson,QB,90,58,-32,4,11,7
4038941,Justin Herbert,QB,92,68,-24,4,8,4
4036131,Noah Fant,TE,94,92,-2,4,3,-1
3042778,Corey Davis,WR,95,107,12,4,2,-2
15072,Marvin Jones Jr.,WR,96,115,19,4,1,-3
3115394,DJ Chark Jr.,WR,98,115,17,4,2,-2
2976316,Michael Thomas,WR,99,96,-3,4,5,1
3925347,Damien Harris,RB,100,81,-19,3,7,4
2576414,Raheem Mostert,RB,101,88,-13,3,5,2
16790,Jarvis Landry,WR,102,106,4,3,2,-1
4241372,Marquise Brown,WR,104,116,12,3,1,-2
3121427,Curtis Samuel,WR,105,123,18,3,1,-2
3045138,Mike Williams,WR,106,126,20,3,1,-2
13934,Antonio Brown,WR,107,111,4,3,3,0
3128721,Sony Michel,RB,108,99,-9,3,3,0
4372016,Jaylen Waddle,WR,110,116,6,3,2,-1
4241475,Henry Ruggs III,WR,111,122,11,2,1,-1
2979843,Kenyan Drake,RB,112,109,-3,2,2,0
3115364,Leonard Fournette,RB,113,98,-15,2,3,1
3045147,James Conner,RB,114,120,6,2,2,0
2576434,Melvin Gordon III,RB,116,107,-9,2,3,1
4239934,AJ Dillon,RB,117,122,5,2,2,0
2980453,Jamaal Williams,RB,118,131,13,2,1,-1
4035676,Zack Moss,RB,119,121,2,2,2,0
4040761,Devin Singletary,RB,120,141,21,2,1,-1
3054212,Jonnu Smith,TE,123,112,-11,2,1,-1
3121023,Dallas Goedert,TE,124,102,-22,2,2,0
2975674,Robert Tonyan,TE,125,97,-28,2,3,1
3116164,Mike Gesicki,TE,126,114,-12,2,1,-1
2330,Tom Brady,QB,127,69,-58,2,7,5
3916430,Nyheim Hines,RB,131,140,9,2,1,-1
4240657,Michael Carter,RB,132,131,-1,2,1,-1
3912550,Ronald Jones II,RB,133,123,-10,2,2,0
4241401,Trey Sermon,RB,134,125,-9,2,3,1
4040715,Jalen Hurts,QB,135,104,-31,2,3,1
14876,Ryan Tannehill,QB,139,112,-27,2,3,1
12483,Matthew Stafford,QB,141,101,-40,2,4,2
4035687,Michael Pittman Jr.,WR,143,136,-7,2,1,-1
3916433,Jakobi Meyers,WR,144,145,1,2,1,-1
15349,Cole Beasley,WR,145,133,-12,2,1,-1
2576623,DeVante Parker,WR,147,149,2,2,0,-2
4035170,Marquez Callaway,WR,148,134,-14,1,2,1
4241802,Jalen Reagor,WR,149,151,2,1,0,-1
2508176,David Johnson,RB,150,144,-6,1,1,0
16913,James White,RB,151,155,4,1,0,-1
2587819,Tyrell Williams,WR,152,160,8,1,0,-1
4035004,Mecole Hardman,WR,154,148,-6,1,1,0
4040655,Darnell Mooney,WR,155,152,-3,1,1,0
3121410,Parris Campbell,WR,156,161,5,1,0,-1
4372414,Elijah Moore,WR,157,161,4,1,0,-1
2573401,Tyler Higbee,TE,159,130,-29,1,1,0
3043275,Austin Hooper,TE,160,147,-13,1,0,-1
3046439,Hunter Henry,TE,161,161,0,1,0,-1
3915511,Joe Burrow,QB,162,124,-38,1,2,1
3052587,Baker Mayfield,QB,164,133,-31,1,1,0
4241479,Tua Tagovailoa,QB,168,147,-21,1,1,0
3052117,Phillip Lindsay,RB,170,147,-23,1,1,0
2572861,J.D. McKissic,RB,171,155,-16,1,0,-1
3916148,Tony Pollard,RB,172,158,-14,1,0,-1
4048244,Alexander Mattison,RB,173,163,-10,1,0,-1
2570986,Malcolm Brown,RB,176,167,-9,1,0,-1
15826,Giovani Bernard,RB,177,168,-9,0,0,0
4569173,Rhamondre Stevenson,RB,178,168,-10,0,0,0
13229,Rob Gronkowski,TE,179,124,-55,0,1,1
3051876,Evan Engram,TE,180,153,-27,0,0,0
4258595,Cole Kmet,TE,184,167,-17,0,0,0
4360310,Trevor Lawrence,QB,185,134,-51,0,2,2
11237,Matt Ryan,QB,187,154,-33,0,1,1
5536,Ben Roethlisberger,QB,189,158,-31,0,0,0
4362887,Justin Fields,QB,191,146,-45,0,1,1
3115378,Russell Gage,WR,194,164,-30,0,0,0
2976592,Sterling Shepard,WR,196,168,-28,0,0,0
2576716,Jamison Crowder,WR,197,167,-30,0,0,0
2971618,Nelson Agholor,WR,198,164,-34,0,0,0
4372485,Rondale Moore,WR,199,168,-31,0,0,0
4362630,Terrace Marshall Jr.,WR,202,168,-34,0,0,0
2979477,Tevin Coleman,RB,203,169,-34,0,0,0
16777,Carlos Hyde,RB,204,169,-35,0,0,0
3895827,Ty'Son Williams,RB,205,166,-39,0,0,0
4038818,Bryan Edwards,WR,206,169,-37,0,0,0
13983,A.J. Green,WR,210,164,-46,0,0,0
14053,Randall Cobb,WR,211,163,-48,0,0,0
4243537,Gabriel Davis,WR,212,169,-43,0,0,0
13295,Emmanuel Sanders,WR,213,169,-44,0,0,0
4374302,Amon-Ra St. Brown,WR,214,170,-44,0,0,0
16732,Eric Ebron,TE,217,162,-55,0,0,0
12537,Jared Cook,TE,219,167,-52,0,0,0
15835,Zach Ertz,TE,220,162,-58,0,0,0
4383351,Trey Lance,QB,221,159,-62,0,1,1
-16027,Buccaneers D/ST,DST,223,83,-140,1,3,2
-16023,Steelers D/ST,DST,226,102,-124,1,2,1
-16033,Ravens D/ST,DST,227,105,-122,1,2,1
-16028,Washington D/ST,DST,228,116,-112,1,2,1
-16025,49ers D/ST,DST,229,123,-106,1,1,0
-16002,Bills D/ST,DST,230,121,-109,1,1,0
-16007,Broncos D/ST,DST,234,143,-91,1,1,0
-16014,Rams D/ST,DST,235,125,-110,1,2,1
-16005,Browns D/ST,DST,236,150,-86,1,1,0
-16011,Colts D/ST,DST,237,153,-84,1,0,-1
-16017,Patriots D/ST,DST,238,148,-90,0,1,1
-16016,Vikings D/ST,DST,239,167,-72,0,0,0
3055899,Harrison Butker,K,240,98,-142,1,3,2
15683,Justin Tucker,K,241,106,-135,1,3,2
12460,Graham Gano,K,242,142,-100,1,1,0
2473037,Jason Myers,K,243,131,-112,1,1,0
16339,Brandon McManus,K,246,146,-100,1,1,0
3124679,Jason Sanders,K,248,145,-103,1,1,0
3049899,Younghoe Koo,K,249,133,-116,1,2,1
4249087,Matt Gay,K,251,146,-105,1,1,0
14993,Greg Zuerlein,K,252,164,-88,1,0,-1
3917232,Tyler Bass,K,255,159,-96,1,1,0
2998120,Josh Lambo,K,256,169,-87,0,0,0
11122,Matt Prater,K,259,166,-93,0,0,0
4258173,Nico Collins,WR,260,170,-90,0,0,0
13981,Mark Ingram II,RB,263,169,-94,0,0,0
3045127,Wayne Gallman II,RB,265,170,-95,0,0,0
3122866,Devontae Booker,RB,269,170,-99,0,0,0
3139925,Rashaad Penny,RB,270,170,-100,0,0,0
3116136,Justin Jackson,RB,273,170,-103,0,0,0
17359,Damien Williams,RB,275,170,-105,0,0,0
4241416,Chuba Hubbard,RB,279,169,-110,0,0,0
15920,Latavius Murray,RB,280,169,-111,0,0,0
3115375,Darrel Williams,RB,283,170,-113,0,0,0
3915411,Ty Johnson,RB,284,170,-114,0,0,0
4243315,Salvon Ahmed,RB,287,170,-117,0,0,0
3139605,Marlon Mack,RB,290,170,-120,0,0,0
3051439,Boston Scott,RB,292,170,-122,0,0,0
4371733,Kenneth Gainwell,RB,294,170,-124,0,0,0
4362452,Jaret Patterson,RB,297,170,-127,0,0,0
15807,Cordarrelle Patterson,RB,299,170,-129,0,0,0
3116389,Samaje Perine,RB,300,170,-130,0,0,0
3049698,Anthony Firkser,TE,302,169,-133,0,0,0
3917792,Daniel Jones,QB,303,168,-135,0,0,0
4360939,Rashod Bateman,WR,305,170,-135,0,0,0
16725,Sammy Watkins,WR,306,170,-136,0,0,0
3128451,Tre'Quan Smith,WR,308,170,-138,0,0,0
3930066,Van Jefferson,WR,309,170,-139,0,0,0
4240600,Kadarius Toney,WR,310,170,-140,0,0,0
4043016,Dee Eskridge,WR,311,170,-141,0,0,0
14880,Kirk Cousins,QB,312,164,-148,0,0,0
8664,Ryan Fitzpatrick,QB,314,166,-148,0,0,0
-16018,Saints D/ST,DST,316,166,-150,0,0,0
-16009,Packers D/ST,DST,317,168,-149,0,0,0
3051909,Daniel Carlson,K,318,169,-149,0,0,0
3150744,Chase McLaughlin,K,319,169,-150,0,0,0
14924,T.Y. Hilton,WR,321,164,-157,0,0,0
3895856,Christian Kirk,WR,322,170,-152,0,0,0
3128390,Allen Lazard,WR,323,170,-153,0,0,0
3051738,Marquez Valdes-Scantling,WR,324,169,-155,0,0,0
3916945,Darius Slayton,WR,325,170,-155,0,0,0
4240380,KJ Hamler,WR,326,170,-156,0,0,0
11283,DeSean Jackson,WR,327,170,-157,0,0,0
3050487,Anthony Miller,WR,328,170,-158,0,0,0
2578533,Chris Conley,WR,329,170,-159,0,0,0
3043116,Demarcus Robinson,WR,330,170,-160,0,0,0
3046409,Alex Collins,RB,332,170,-162,0,0,0
4241555,Elijah Mitchell,RB,334,170,-164,0,0,0
16782,Jerick McKinnon,RB,335,170,-165,0,0,0
3910544,Joshua Kelley,RB,336,170,-166,0,0,0
3066158,Tarik Cohen,RB,337,170,-167,0,0,0
4036431,Darrynton Evans,RB,339,171,-168,0,0,0
4046676,Tony Jones Jr.,RB,340,170,-170,0,0,0
4046530,Chris Evans,RB,341,170,-171,0,0,0
2969939,Jameis Winston,QB,342,160,-182,0,1,1
4361259,Zach Wilson,QB,344,167,-177,0,0,0
16757,Derek Carr,QB,348,166,-182,0,0,0
3918639,Gerald Everett,TE,350,169,-181,0,0,0
2991767,Blake Jarwin,TE,351,169,-182,0,0,0
3915486,Tyler Conklin,TE,352,170,-182,0,0,0
3930086,Dawson Knox,TE,353,170,-183,0,0,0
4241941,Anthony McFarland Jr.,RB,355,170,-185,0,0,0
4361577,Dyami Brown,WR,356,170,-186,0,0,0
4036416,Byron Pringle,WR,357,170,-187,0,0,0
-16015,Dolphins D/ST,DST,358,167,-191,0,0,0
-16019,Giants D/ST,DST,359,170,-189,0,0,0
12731,Ryan Succop,K,362,168,-194,0,0,0
3127313,Tristan Vizcaino,K,363,170,-193,0,0,0
3929645,Juwan Johnson,TE,364,170,-194,0,0,0
3911853,Adam Trautman,TE,365,170,-195,0,0,0
2574576,C.J. Uzomah,TE,366,170,-196,0,0,0
4035793,Quintez Cephus,WR,368,170,-198,0,0,0
4242433,Joshua Palmer,WR,369,170,-199,0,0,0
3917914,Olamide Zaccheaus,WR,370,170,-200,0,0,0
3071572,Keelan Cole,WR,371,170,-201,0,0,0
2983509,Dare Ogunbowale,RB,372,170,-202,0,0,0
4038441,Justice Hill,RB,375,170,-205,0,0,0
2573079,Carson Wentz,QB,377,169,-208,0,0,0
4241464,Mac Jones,QB,381,165,-216,0,0,0
3046779,Jared Goff,QB,384,169,-215,0,0,0
16728,Teddy Bridgewater,QB,386,169,-217,0,0,0
3912547,Sam Darnold,QB,389,169,-220,0,0,0
4258195,Donovan Peoples-Jones,WR,391,170,-221,0,0,0
3134353,Tim Patrick,WR,392,170,-222,0,0,0
2973405,Kalif Raymond,WR,393,170,-223,0,0,0
3135321,Hunter Renfrow,WR,394,170,-224,0,0,0
2978109,Zach Pascal,WR,396,170,-226,0,0,0
4240631,DeeJay Dallas,RB,397,170,-227,0,0,0
4035072,Benny Snell Jr.,RB,398,170,-228,0,0,0
4036224,Jake Funk,RB,399,169,-230,0,0,0
15971,Rex Burkhead,RB,400,170,-230,0,0,0
4039607,J.J. Taylor,RB,403,169,-234,0,0,0
4034952,La'Mical Perine,RB,404,170,-234,0,0,0
4241205,Larry Rountree III,RB,405,170,-235,0,0,0
16002,Kyle Juszczyk,RB,406,170,-236,0,0,0
3115306,Josh Reynolds,WR,407,170,-237,0,0,0
-16003,Bears D/ST,DST,409,169,-240,0,0,0
-16010,Titans D/ST,DST,410,169,-241,0,0,0
9354,Robbie Gould,K,411,169,-242,0,0,0
15965,Dustin Hopkins,K,412,170,-242,0,0,0
3043080,O.J. Howard,TE,413,169,-244,0,0,0
2582410,Tyler Kroft,TE,416,170,-246,0,0,0
3128452,Jordan Akins,TE,417,170,-247,0,0,0
3924365,Hayden Hurst,TE,418,170,-248,0,0,0
4212989,Dan Arnold,TE,419,170,-249,0,0,0
3045523,Kendrick Bourne,WR,420,170,-250,0,0,0
3122449,James Washington,WR,422,170,-252,0,0,0
14163,Tyrod Taylor,QB,423,170,-253,0,0,0
-16022,Cardinals D/ST,DST,425,169,-256,0,0,0
-16029,Panthers D/ST,DST,426,169,-257,0,0,0
-16012,Chiefs D/ST,DST,427,167,-260,0,0,0
-16001,Falcons D/ST,DST,428,170,-258,0,0,0
16760,Jimmy Garoppolo,QB,430,169,-261,0,0,0
3122840,Deshaun Watson,QB,431,168,-263,0,0,0
2972091,Jalen Richard,RB,432,170,-262,0,0,0
3127586,Jeremy McNichols,RB,433,170,-263,0,0,0
4820592,Nate McCrary,RB,435,170,-265,0,0,0
4374033,Jermar Jefferson,RB,436,170,-266,0,0,0
4035537,Kene Nwangwu,RB,437,170,-267,0,0,0
4039274,Jonathan Ward,RB,438,170,-268,0,0,0
3051902,Peyton Barber,RB,439,170,-269,0,0,0
2468609,Taysom Hill,QB,441,169,-272,0,0,0
3117256,Dalton Schultz,TE,442,170,-272,0,0,0
16504,Jack Doyle,TE,443,170,-273,0,0,0
13232,Jimmy Graham,TE,444,169,-275,0,0,0
14054,Kyle Rudolph,TE,446,169,-277,0,0,0
14012,Andy Dalton,QB,450,170,-280,0,0,0
3924327,Drew Lock,QB,451,170,-281,0,0,0
4035003,Jacob Eason,QB,454,170,-284,0,0,0
4242546,Davis Mills,QB,455,170,-285,0,0,0
4038524,Gardner Minshew II,QB,456,169,-287,0,0,0
3928925,JaMycal Hasty,RB,457,170,-287,0,0,0
3049916,Matt Breida,RB,458,170,-288,0,0,0
3139602,D'Ernest Johnson,RB,459,170,-289,0,0,0
3912092,Donald Parham Jr.,TE,460,170,-290,0,0,0
3127292,Will Dissly,TE,461,169,-292,0,0,0
3123050,Chris Herndon,TE,465,170,-295,0,0,0
2998565,Mo Alie-Cox,TE,466,169,-297,0,0,0
4361411,Pat Freiermuth,TE,467,168,-299,0,0,0
4039160,Kylen Granson,TE,468,169,-299,0,0,0
2970726,Maxx Williams,TE,469,169,-300,0,0,0
3123076,David Njoku,TE,470,169,-301,0,0,0
4040774,Harrison Bryant,TE,471,169,-302,0,0,0
2508079,James O'Shaughnessy,TE,472,169,-303,0,0,0
3046704,Geoff Swaim,TE,473,169,-304,0,0,0
2531358,Chris Manhertz,TE,474,169,-305,0,0,0
2578570,Jacoby Brissett,QB,476,170,-306,0,0,0
2576980,Marcus Mariota,QB,478,169,-309,0,0,0
3039707,Mitchell Trubisky,QB,479,169,-310,0,0,0
2565969,Taylor Heinicke,QB,480,169,-311,0,0,0
4036378,Jordan Love,QB,481,169,-312,0,0,0
3116407,Mason Rudolph,QB,483,169,-314,0,0,0
4240904,Kellen Mond,QB,484,169,-315,0,0,0
3051308,P.J. Walker,QB,485,169,-316,0,0,0
4035671,Tyler Huntley,QB,486,169,-317,0,0,0
3124092,John Wolford,QB,487,169,-318,0,0,0
3915165,Rodrigo Blankenship,K,488,167,-321,0,0,0
4360234,Evan McPherson,K,490,169,-321,0,0,0
2971573,Ka'imi Fairbairn,K,491,170,-321,0,0,0
10636,Mason Crosby,K,492,168,-324,0,0,0
17372,Chris Boswell,K,493,169,-324,0,0,0
3975763,Greg Joseph,K,495,169,-326,0,0,0
3821683,Austin Seibert,K,496,169,-327,0,0,0
17427,Cairo Santos,K,497,169,-328,0,0,0
3050478,Jake Elliott,K,498,169,-329,0,0,0
3919602,Matt Ammendola,K,499,169,-330,0,0,0
4046532,Quinn Nordin,K,502,169,-333,0,0,0
2582139,Sam Ficken,K,503,169,-334,0,0,0
3040204,Ryan Santoso,K,504,170,-334,0,0,0
2985659,Wil Lutz,K,505,169,-336,0,0,0
-16021,Eagles D/ST,DST,506,169,-337,0,0,0
-16020,Jets D/ST,DST,509,170,-339,0,0,0
-16026,Seahawks D/ST,DST,511,169,-342,0,0,0
-16024,Chargers D/ST,DST,513,169,-344,0,0,0
-16004,Bengals D/ST,DST,515,169,-346,0,0,0
-16006,Cowboys D/ST,DST,516,169,-347,0,0,0
-16030,Jaguars D/ST,DST,517,169,-348,0,0,0
-16013,Raiders D/ST,DST,518,169,-349,0,0,0
-16008,Lions D/ST,DST,519,169,-350,0,0,0
-16034,Texans D/ST,DST,520,169,-351,0,0,0
4050373,Quez Watkins,WR,1012,169,-843,0,0,0
4411193,Deonte Harris,WR,1013,169,-844,0,0,0
3932430,Jalen Guyton,WR,1014,170,-844,0,0,0
4360797,Tutu Atwell,WR,1015,170,-845,0,0,0
3128724,Isaiah McKenzie,WR,1016,169,-847,0,0,0
3921564,Auden Tate,WR,1017,169,-848,0,0,0
2576491,Adam Humphries,WR,1018,170,-848,0,0,0
17258,Willie Snead IV,WR,1019,169,-850,0,0,0
4239992,Amari Rodgers,WR,1020,169,-851,0,0,0
15773,Darren Fells,TE,1021,169,-852,0,0,0
4035403,Denzel Mims,WR,1022,170,-852,0,0,0
3892889,Dede Westbrook,WR,1023,169,-854,0,0,0
3894912,Tyron Johnson,WR,1024,169,-855,0,0,0
3042910,Rashard Higgins,WR,1025,169,-856,0,0,0
2577667,Damiere Byrd,WR,1026,170,-856,0,0,0
3914397,Scotty Miller,WR,1027,169,-858,0,0,0
3122818,Tommy Sweeney,TE,1028,169,-859,0,0,0
3121409,Noah Brown,WR,1029,169,-860,0,0,0
4362504,Brevin Jordan,TE,1030,169,-861,0,0,0
3843945,Foster Moreau,TE,1031,169,-862,0,0,0
3918003,Brycen Hopkins,TE,1032,169,-863,0,0,0
3127310,Drew Sample,TE,1033,169,-864,0,0,0
17051,Albert Wilson,WR,1034,169,-865,0,0,0
3126002,Christian Blake,WR,1035,169,-866,0,0,0
4035115,Albert Okwuegbunam,TE,1036,169,-867,0,0,0
3728262,Ray-Ray McCloud,WR,1037,169,-868,0,0,0
3061612,Jamal Agnew,WR,1038,169,-869,0,0,0
2577134,Ty Montgomery,WR,1039,169,-870,0,0,0
4240573,Ihmir Smith-Marsette,WR,1040,169,-871,0,0,0
4039050,Devin Duvernay,WR,1041,169,-872,0,0,0
2574591,Nick Boyle,TE,1042,169,-873,0,0,0
4036335,Cedrick Wilson,WR,1043,169,-874,0,0,0
3915399,Preston Williams,WR,1044,169,-875,0,0,0
4034950,Freddie Swain,WR,1045,169,-876,0,0,0
15839,Marquise Goodwin,WR,1046,169,-877,0,0,0
13226,Andre Roberts,WR,1047,169,-878,0,0,0
14922,Mohamed Sanu Sr.,WR,1048,169,-879,0,0,0
2971281,Pharaoh Brown,TE,1049,169,-880,0,0,0
3052166,Darrell Daniels,TE,1050,169,-881,0,0,0
3052897,Durham Smythe,TE,1051,169,-882,0,0,0
3139456,Cameron Batson,WR,1052,169,-883,0,0,0
17453,Cameron Brate,TE,1053,169,-884,0,0,0
4422214,Trinity Benson,WR,1054,169,-885,0,0,0
2514206,Blake Bell,TE,1055,169,-886,0,0,0
15887,Ryan Griffin,TE,1056,169,-887,0,0,0
3040035,Greg Ward,WR,1057,169,-888,0,0,0
3122168,Trent Sherfield,WR,1058,169,-889,0,0,0
3115328,Jalen Hurd,WR,1059,169,-890,0,0,0
3128774,Kalen Ballage,RB,1060,169,-891,0,0,0
4047839,N'Keal Harry,WR,1061,169,-892,0,0,0
4259499,Shi Smith,WR,1062,169,-893,0,0,0
13987,Blaine Gabbert,QB,1063,169,-894,0,0,0
3122672,Royce Freeman,RB,1064,170,-894,0,0,0
4039043,Collin Johnson,WR,1065,169,-896,0,0,0
2310331,Tyler Johnson,WR,1066,169,-897,0,0,0
3915522,KJ Hill Jr.,WR,1067,169,-898,0,0,0
2972460,Breshad Perriman,WR,1068,170,-898,0,0,0
9614,Marcedes Lewis,TE,1069,169,-900,0,0,0
4259805,Kylin Hill,RB,1070,169,-901,0,0,0
2975417,Patrick Ricard,RB,1071,169,-902,0,0,0
4242557,Colby Parkinson,TE,1072,169,-903,0,0,0
3914151,Josiah Deguara,TE,1073,169,-904,0,0,0
3917668,Alec Ingold,RB,1074,169,-905,0,0,0
3932144,Jacob Harris,TE,1075,169,-906,0,0,0
4012556,C.J. Ham,RB,1076,169,-907,0,0,0
4239944,Hunter Long,TE,1077,169,-908,0,0,0
4371986,Anthony Schwartz,WR,1078,169,-909,0,0,0
3916566,K.J. Osborn,WR,1079,169,-910,0,0,0
4047836,Frank Darby,WR,1080,169,-911,0,0,0
4044452,Kaden Smith,TE,1081,169,-912,0,0,0
3059722,Zay Jones,WR,1082,169,-913,0,0,0
4039057,Lil'Jordan Humphrey,WR,1083,169,-914,0,0,0
4379504,Mekhi Sargent,RB,1084,169,-915,0,0,0
17463,Diontae Spencer,WR,1085,169,-916,0,0,0
3120303,Ross Dwelley,TE,1086,169,-917,0,0,0
3921690,Josh Oliver,TE,1087,169,-918,0,0,0
3051381,Mike White,QB,1088,169,-919,0,0,0
4040612,Luke Farrell,TE,1089,169,-920,0,0,0
4045305,Ian Thomas,TE,1090,169,-921,0,0,0
4241424,Tylan Wallace,WR,1091,169,-922,0,0,0
4424106,Gunner Olszewski,WR,1092,169,-923,0,0,0
3045260,Corey Clement,RB,1093,169,-924,0,0,0
4242873,Eno Benjamin,RB,1094,169,-925,0,0,0
11291,Chad Henne,QB,1095,169,-926,0,0,0
4294520,Brandon Zylstra,WR,1096,169,-927,0,0,0
3047876,KhaDarel Hodge,WR,1097,169,-928,0,0,0
3914328,Andy Isabella,WR,1098,169,-929,0,0,0
3123986,Mike Thomas,WR,1099,169,-930,0,0,0
4245645,Gary Brightwell,RB,1100,169,-931,0,0,0
4240023,Tre' McKitty,TE,1101,169,-932,0,0,0
4046522,Devin Asiasi,TE,1102,169,-933,0,0,0
3115252,Will Grier,QB,1103,169,-934,0,0,0
3929785,Nick Westbrook-Ikhine,WR,1104,169,-935,0,0,0
3040206,Chris Streveler,QB,1105,169,-936,0,0,0
12471,Chase Daniel,QB,1106,169,-937,0,0,0
2577641,Jakeem Grant Sr.,WR,1107,169,-938,0,0,0
4243830,Jaelon Darden,WR,1108,169,-939,0,0,0
15864,Geno Smith,QB,1109,169,-940,0,0,0
2574511,Brandon Allen,QB,1110,169,-941,0,0,0
2576399,Nick Vannett,TE,1111,169,-942,0,0,0
4037457,Travis Homer,RB,1112,169,-943,0,0,0
2979520,C.J. Beathard,QB,1113,170,-943,0,0,0
12477,Brian Hoyer,QB,1114,169,-945,0,0,0
15837,Mike Glennon,QB,1115,169,-946,0,0,0
4408988,Malik Taylor,WR,1116,169,-947,0,0,0
3116188,David Blough,QB,1117,169,-948,0,0,0
4034948,Feleipe Franks,QB,1118,169,-949,0,0,0
3042749,Logan Woodside,QB,1119,169,-950,0,0,0
3929924,Zach Gentry,TE,1120,169,-951,0,0,0
3085107,Jake Kumerow,WR,1121,169,-952,0,0,0
4035886,Khalil Herbert,RB,1122,169,-953,0,0,0
4035611,Gabe Nabers,RB,1123,169,-954,0,0,0
3052096,Johnny Mundt,TE,1124,169,-955,0,0,0
4589245,Mike Strachan,WR,1125,169,-956,0,0,0
4360739,Simi Fehoko,WR,1126,169,-957,0,0,0
15168,Case Keenum,QB,1127,169,-958,0,0,0
14215,Lee Smith,TE,1128,169,-959,0,0,0
4240472,Noah Gray,TE,1129,169,-960,0,0,0
4036129,Dominique Dafney,TE,1130,169,-961,0,0,0
2982828,Tajae Sharpe,WR,1131,169,-962,0,0,0
17315,Keith Smith,RB,1132,169,-963,0,0,0
3119317,Nsimba Webster,WR,1133,169,-964,0,0,0
4035826,Demetric Felton,RB,1134,169,-965,0,0,0
16318,Demetrius Harris,TE,1135,169,-966,0,0,0
3917612,Ke'Shawn Vaughn,RB,1136,169,-967,0,0,0
4048228,John Bates,TE,1137,169,-968,0,0,0
2973626,C.J. Board,WR,1138,169,-969,0,0,0
3931397,J.J. Arcega-Whiteside,WR,1139,169,-970,0,0,0
2975863,Eric Saubert,TE,1140,169,-971,0,0,0
4061956,Ashton Dulin,WR,1141,169,-972,0,0,0
2519013,Daniel Brown,TE,1142,169,-973,0,0,0
3125404,Jacob Hollister,TE,1143,169,-974,0,0,0
4035020,Charlie Woerner,TE,1144,169,-975,0,0,0
2983209,Chester Rogers,WR,1145,169,-976,0,0,0
4242231,Racey McMath,WR,1146,169,-977,0,0,0
2974317,Andy Janovich,RB,1147,169,-978,0,0,0
4372780,Tommy Tremble,TE,1148,169,-979,0,0,0
3115349,Jakob Johnson,RB,1149,169,-980,0,0,0
3886598,Jauan Jennings,WR,1150,169,-981,0,0,0
3122154,Khari Blasingame,RB,1151,169,-982,0,0,0
4039436,Malcolm Perry,WR,1153,169,-984,0,0,0
3123075,Braxton Berrios,WR,1154,169,-985,0,0,0
2515270,Michael Burton,RB,1155,169,-986,0,0,0
3932423,Miles Boykin,WR,1156,169,-987,0,0,0
3916204,James Proche II,WR,1157,169,-988,0,0,0
3115314,Cam Sims,WR,1158,169,-989,0,0,0
3051891,Jordan Wilkins,RB,1159,169,-990,0,0,0
2575965,Elijhaa Penny,RB,1160,169,-991,0,0,0
2511973,Eric Tomlinson,TE,1161,169,-992,0,0,0
2580216,DeAndre Carter,WR,1162,169,-993,0,0,0
3120659,Daurice Fountain,WR,1163,169,-994,0,0,0
3046399,Marcus Kemp,WR,1164,169,-995,0,0,0
4408854,Jody Fortson,TE,1165,169,-996,0,0,0
4198676,Adam Shaheen,TE,1166,169,-997,0,0,0
2576854,Stephen Anderson,TE,1167,169,-998,0,0,0
2987440,Garrett Griffin,TE,1168,169,-999,0,0,0
3051806,Ricky Seals-Jones,TE,1169,169,-1000,0,0,0
3699902,Stanley Morgan,WR,1170,169,-1001,0,0,0
15403,Derek Carrier,TE,1171,169,-1002,0,0,0
2991662,Mack Hollins,WR,1172,169,-1003,0,0,0
4373642,Dax Milne,WR,1173,169,-1004,0,0,0
3040470,Cethan Carter,TE,1174,169,-1005,0,0,0
4411192,Brandon Dillon,TE,1175,169,-1006,0,0,0
3148929,Sammis Reyes,TE,1176,169,-1007,0,0,0
3940587,Jesper Horsted,TE,1177,169,-1008,0,0,0
4043161,Antoine Wesley,WR,1178,169,-1009,0,0,0
2980120,Colin Thompson,TE,1179,169,-1010,0,0,0
3930900,Ben Ellefson,TE,1180,169,-1011,0,0,0
2979590,Jesse James,TE,1181,169,-1012,0,0,0
3116158,Jason Cabinda,RB,1182,169,-1013,0,0,0
3929118,Jeff Smith,WR,1183,169,-1014,0,0,0
2576450,Derek Watt,RB,1184,169,-1015,0,0,0
14167,Taiwan Jones,RB,1185,169,-1016,0,0,0
4362878,Scottie Phillips,RB,1186,169,-1017,0,0,0
3045238,Godwin Igwebuike,RB,1187,169,-1018,0,0,0
3002265,Dwayne Washington,RB,1188,169,-1019,0,0,0
13199,Colt McCoy,QB,1274,169,-1105,0,0,0
16810,AJ McCarron,QB,1275,169,-1106,0,0,0
11387,Matthew Slater,WR,1276,169,-1107,0,0,0
17177,Allen Hurns,WR,1277,169,-1108,0,0,0
3047968,Chad Beebe,WR,1339,169,-1170,0,0,0
3039725,Ryan Switzer,WR,1340,169,-1171,0,0,0
4035379,Jordan Thomas,TE,1341,169,-1172,0,0,0
3045264,Troy Fumagalli,TE,1342,169,-1173,0,0,0
3122899,Richie James,WR,1343,169,-1174,0,0,0
3118892,Justin Watson,WR,1344,169,-1175,0,0,0
3052576,Dylan Cantrell,TE,1345,169,-1176,0,0,0
2971718,Marcus Johnson,WR,1346,169,-1177,0,0,0
3115928,Malik Turner,WR,1347,169,-1178,0,0,0
3044720,Joshua Dobbs,QB,1348,169,-1179,0,0,0
3115293,Kyle Allen,QB,1349,169,-1180,0,0,0
2972515,Cooper Rush,QB,1350,169,-1181,0,0,0
2972236,Nathan Peterman,QB,1361,169,-1192,0,0,0
3046705,Tyrone Swoopes,TE,1368,169,-1199,0,0,0
2577731,Alex Ellis,TE,1370,169,-1201,0,0,0
2515759,J.J. Nelson,WR,1393,169,-1224,0,0,0
15786,Tavon Austin,WR,1394,169,-1225,0,0,0
3728254,Deon Cain,WR,1395,169,-1226,0,0,0
3059760,Taywan Taylor,WR,1396,169,-1227,0,0,0
2972240,Jason Croom,TE,1397,169,-1228,0,0,0
3892775,Jarrett Stidham,QB,1408,169,-1239,0,0,0
3915174,Terry Godwin,WR,1410,169,-1241,0,0,0
3933064,John Ursua,WR,1413,169,-1244,0,0,0
3120590,Easton Stick,QB,1414,169,-1245,0,0,0
3122143,Cullen Gillaspia,RB,1415,169,-1246,0,0,0
3917067,Bisi Johnson,WR,1422,169,-1253,0,0,0
3122976,Jeff Wilson Jr.,RB,1425,170,-1255,0,0,0
3045169,Tim Boyle,QB,1430,169,-1261,0,0,0
15478,Brandon Bolden,RB,1431,169,-1262,0,0,0
14471,Nick Bellore,RB,1437,169,-1268,0,0,0
4040616,Dwayne Haskins,QB,1438,169,-1269,0,0,0
4040980,Irv Smith Jr.,TE,1439,163,-1276,0,0,0
3917962,Jace Sternberger,TE,1440,169,-1271,0,0,0
3886377,Josh Rosen,QB,1441,169,-1272,0,0,0
3052177,John Ross,WR,1442,169,-1273,0,0,0
3057987,DaeSean Hamilton,WR,1443,169,-1274,0,0,0
3139033,Mike Boone,RB,1444,170,-1274,0,0,0
15980,Levine Toilolo,TE,1447,169,-1278,0,0,0
14877,Nick Foles,QB,1448,169,-1279,0,0,0
11252,Joe Flacco,QB,1449,169,-1280,0,0,0
3916564,Tyree Jackson,TE,1450,169,-1281,0,0,0
3118954,Jaeden Graham,TE,1451,169,-1282,0,0,0
3125107,Andrew Beck,RB,1459,169,-1290,0,0,0
3948283,Stephen Carlson,TE,1460,169,-1291,0,0,0
2970262,J.P. Holtz,RB,1461,169,-1292,0,0,0
3915296,Michael Walker,WR,1462,169,-1293,0,0,0
3933568,Davion Davis,WR,1471,169,-1302,0,0,0
3126997,Tom Kennedy,WR,1472,169,-1303,0,0,0
4240021,Cam Akers,RB,1474,169,-1305,0,0,0
4241985,J.K. Dobbins,RB,1475,146,-1329,0,3,3
4259979,Lynn Bowden Jr.,WR,1476,169,-1307,0,0,0
4240861,Dalton Keene,TE,1483,169,-1314,0,0,0
4040732,Raymond Calais,RB,1484,169,-1315,0,0,0
4054085,Dezmon Patmon,WR,1499,169,-1330,0,0,0
4036149,Nate Stanley,QB,1502,169,-1333,0,0,0
3124900,Jake Luton,QB,1503,169,-1334,0,0,0
3916721,LeVante Bellamy,RB,1514,169,-1345,0,0,0
4042112,Adrian Killins,RB,1515,169,-1346,0,0,0
4243318,Hunter Bryant,TE,1516,169,-1347,0,0,0
4039505,Reggie Gilliam,RB,1517,169,-1348,0,0,0
4038815,Rico Dowdle,RB,1518,169,-1349,0,0,0
4036275,Sean McKeon,TE,1519,169,-1350,0,0,0
3916209,Xavier Jones,RB,1520,170,-1350,0,0,0
3929637,Dan Chisena,WR,1521,169,-1352,0,0,0
4040623,Austin Mack,WR,1536,169,-1367,0,0,0
4038539,Sewo Olonilua,RB,1537,169,-1368,0,0,0
4239996,Travis Etienne Jr.,RB,1549,169,-1380,0,0,0
4034946,Kyle Trask,QB,1550,169,-1381,0,0,0
4046678,Ian Book,QB,1574,169,-1405,0,0,0
4241820,Sam Ehlinger,QB,1588,169,-1419,0,0,0
4039307,Marquez Stevenson,WR,1601,169,-1432,0,0,0
4035656,Ben Skowronek,WR,1608,169,-1439,0,0,0
16143,Josh Hill,TE,1668,169,-1499,0,0,0
16172,Jaron Brown,WR,1669,169,-1500,0,0,0
15003,Rhett Ellison,TE,1670,169,-1501,0,0,0
14085,Virgil Green,TE,1671,169,-1502,0,0,0
15204,Garrett Celek,TE,1673,169,-1504,0,0,0
14332,Patrick DiMarco,RB,1674,169,-1505,0,0,0
17348,Xavier Grimble,TE,1675,169,-1506,0,0,0
14918,Jarius Wright,WR,1676,169,-1507,0,0,0
13940,James Develin,RB,1677,169,-1508,0,0,0
5615,Matt Schaub,QB,1681,169,-1512,0,0,0
17223,Roosevelt Nix,RB,1682,169,-1513,0,0,0
15693,Alex Tanney,QB,1683,169,-1514,0,0,0
17391,Scott Simonson,TE,1685,169,-1516,0,0,0
15948,Matt Barkley,QB,1686,169,-1517,0,0,0
15705,Josh Gordon,WR,1687,169,-1518,0,0,0
16366,Zach Line,RB,1695,169,-1526,0,0,0
14145,Charles Clay,TE,1697,169,-1528,0,0,0
4527,Jason Witten,TE,1698,169,-1529,0,0,0
9592,Vernon Davis,TE,1700,169,-1531,0,0,0
2980444,Bronson Kaufusi,TE,1772,169,-1603,0,0,0
17402,Seth Roberts,WR,1817,169,-1648,0,0,0
2577654,DeAndre Washington,RB,1818,169,-1649,0,0,0
3046320,Marcell Ateman,WR,1819,169,-1650,0,0,0
3066052,Chad Williams,WR,1820,169,-1651,0,0,0
2576581,Chris Moore,WR,1821,169,-1652,0,0,0
3932935,Deontay Burnett,WR,1822,169,-1653,0,0,0
3134302,Jordan Lasley,WR,1823,169,-1654,0,0,0
2579846,Ben Koyack,TE,1824,169,-1655,0,0,0
4040792,Jaleel Scott,WR,1825,169,-1656,0,0,0
2972331,Mason Schreck,TE,1826,169,-1657,0,0,0
3115255,Brandon Powell,WR,1827,169,-1658,0,0,0
2470916,Matt Lengel,TE,1828,169,-1659,0,0,0
3045380,Bobo Wilson,WR,1829,169,-1660,0,0,0
3042417,Shelton Gibson,WR,1830,169,-1661,0,0,0
2573974,Tyler Ervin,RB,1831,169,-1662,0,0,0
3051889,Laquon Treadwell,WR,1832,169,-1663,0,0,0
2476373,Jerome Cunningham,TE,1833,169,-1664,0,0,0
3116563,Shaun Wilson,RB,1834,169,-1665,0,0,0
2578369,Marvin Hall,WR,1835,169,-1666,0,0,0
3048924,David Williams,RB,1836,169,-1667,0,0,0
3121583,Roc Thomas,RB,1837,169,-1668,0,0,0
3895857,Damion Ratley,WR,1838,169,-1669,0,0,0
2980460,Gehrig Dieter,WR,1839,169,-1670,0,0,0
2576804,Nick O'Leary,TE,1840,169,-1671,0,0,0
2980378,Cody Core,WR,1841,169,-1672,0,0,0
3052056,River Cracraft,WR,1842,169,-1673,0,0,0
3895789,Quadree Henderson,WR,1843,169,-1674,0,0,0
3040569,Trent Taylor,WR,1844,169,-1675,0,0,0
3046401,Keith Kirkwood,WR,1845,169,-1676,0,0,0
2980073,Jeremy Sprinkle,TE,1846,169,-1677,0,0,0
2577808,Darius Jennings,WR,1847,169,-1678,0,0,0
3128439,Jordan Franks,TE,1848,169,-1679,0,0,0
4035019,Javon Wims,WR,1849,169,-1680,0,0,0
3125403,Brian Hill,RB,1850,170,-1680,0,0,0
3039723,T.J. Logan,RB,1851,169,-1682,0,0,0
2574918,Tommylee Lewis,WR,1852,169,-1683,0,0,0
3056577,Da'Mari Scott,WR,1853,169,-1684,0,0,0
2977800,Alex Erickson,WR,1854,169,-1685,0,0,0
3126246,Dontrell Hilliard,RB,1855,169,-1686,0,0,0
2566659,Seth DeValve,TE,1856,169,-1687,0,0,0
3122920,Ryan Izzo,TE,1857,169,-1688,0,0,0
2578377,Joshua Perkins,TE,1858,169,-1689,0,0,0
3917846,Mark Walton,RB,1859,169,-1690,0,0,0
4329491,Jalen Tolliver,WR,1860,169,-1691,0,0,0
3122430,Chris Lacy,WR,1861,169,-1692,0,0,0
4212884,Alex Armah,RB,1862,169,-1693,0,0,0
3122716,Buddy Howell,RB,1863,169,-1694,0,0,0
2979501,Nate Sudfeld,QB,1864,169,-1695,0,0,0
3129302,DeShone Kizer,QB,1865,169,-1696,0,0,0
16994,David Fluellen,RB,1866,169,-1697,0,0,0
2574630,Jeff Driskel,QB,1867,169,-1698,0,0,0
3052600,Davis Webb,QB,1868,169,-1699,0,0,0
3049872,Kyle Lauletta,QB,1869,169,-1700,0,0,0
3052061,Luke Falk,QB,1870,169,-1701,0,0,0
2971830,JoJo Natson,WR,1871,169,-1702,0,0,0
3048897,Pharoh Cooper,WR,1872,169,-1703,0,0,0
2580330,Temarrick Hemingway,TE,1909,169,-1740,0,0,0
2576395,Devin Smith,WR,1910,169,-1741,0,0,0
2983319,Troymaine Pope,RB,1912,169,-1743,0,0,0
2978308,Jaydon Mickens,WR,1913,169,-1744,0,0,0
2508256,MyCole Pruitt,TE,1914,169,-1745,0,0,0
3039794,James Looney,TE,1917,169,-1748,0,0,0
3040137,Derrick Willies,WR,1918,169,-1749,0,0,0
4081127,Antony Auclair,TE,1919,169,-1750,0,0,0
3066147,Jawill Davis,WR,1920,169,-1751,0,0,0
3041097,Tanner Lee,QB,1922,169,-1753,0,0,0
3116132,Garrett Dickerson,TE,1924,169,-1755,0,0,0
3042373,Robert Davis,WR,1925,169,-1756,0,0,0
2978124,D.J. Foster,RB,1928,169,-1759,0,0,0
3124069,Isaiah Ford,WR,1931,169,-1762,0,0,0
3125232,Nick Bawden,RB,1932,169,-1763,0,0,0
2576165,Josh Ferguson,RB,1933,169,-1764,0,0,0
2512593,Clive Walford,TE,1937,169,-1768,0,0,0
2974339,Austin Carr,WR,1939,169,-1770,0,0,0
2971426,Sean Culkin,TE,1940,169,-1771,0,0,0
2974365,Danny Vitale,RB,1942,169,-1773,0,0,0
4329471,J.J. Jones,WR,1943,169,-1774,0,0,0
3056906,Johnny Holton,WR,1944,169,-1775,0,0,0
3066074,Chad Hansen,WR,1947,169,-1778,0,0,0
2515962,DeAndrew White,WR,1950,169,-1781,0,0,0
3115330,Josh Malone,WR,1951,169,-1782,0,0,0
2573343,Trevor Davis,WR,1952,169,-1783,0,0,0
3116680,Austin Proehl,WR,1953,169,-1784,0,0,0
3117131,Detrez Newsome,RB,1955,169,-1786,0,0,0
2978244,Ricky Ortiz,RB,1957,169,-1788,0,0,0
2968204,Cole Hikutini,TE,1960,169,-1791,0,0,0
2969241,Ben Braunecker,TE,1962,169,-1793,0,0,0
3124079,Cam Phillips,WR,1964,169,-1795,0,0,0
3051650,Darvin Kidsy,WR,1967,169,-1798,0,0,0
3126367,Bo Scarbrough,RB,1968,169,-1799,0,0,0
3128251,Simmie Cobbs Jr.,WR,1970,169,-1801,0,0,0
2971280,Evan Baylis,TE,1971,169,-1802,0,0,0
3128843,Alex McGough,QB,1973,169,-1804,0,0,0
3129455,Donnie Ernsberger,TE,1974,169,-1805,0,0,0
2980077,Jonathan Williams,RB,1975,169,-1806,0,0,0
3155188,Vyncint Smith,WR,1976,169,-1807,0,0,0
3052143,Khalfani Muhammad,RB,1977,169,-1808,0,0,0
3894883,Isaac Whitney,WR,1978,169,-1809,0,0,0
2980148,C.J. Prosise,RB,1980,169,-1811,0,0,0
3052450,Danny Etling,QB,1982,169,-1813,0,0,0
3928461,De'Lance Turner,RB,1983,169,-1814,0,0,0
2972283,Tra Carson,RB,1984,169,-1815,0,0,0
3936647,Ross Travis,TE,1986,169,-1817,0,0,0
4198679,Krishawn Hogan,WR,1988,169,-1819,0,0,0
2971589,Paul Perkins,RB,1990,169,-1821,0,0,0
2970090,Trey Edmunds,RB,1992,169,-1823,0,0,0
3056476,Victor Bolden,WR,1994,169,-1825,0,0,0
3047488,Matt Flanagan,TE,1995,169,-1826,0,0,0
2579604,Phillip Dorsett II,WR,2034,169,-1865,0,0,0
14402,Chris Hogan,WR,2035,169,-1866,0,0,0
16793,Cody Latimer,WR,2036,169,-1867,0,0,0
4036163,Kelvin Harmon,WR,2037,169,-1868,0,0,0
2518678,Justin Hardy,WR,2038,169,-1869,0,0,0
16121,Luke Willson,TE,2039,169,-1870,0,0,0
3045225,Jake Butt,TE,2040,169,-1871,0,0,0
2576389,Jeff Heuerman,TE,2041,169,-1872,0,0,0
3124537,KeeSean Johnson,WR,2042,169,-1873,0,0,0
3139522,Travis Fulgham,WR,2043,169,-1874,0,0,0
2576179,Matt LaCosse,TE,2044,169,-1875,0,0,0
3933327,Kahale Warring,TE,2045,169,-1876,0,0,0
16845,Ryan Grant,WR,2046,169,-1877,0,0,0
15555,Josh Bellamy,WR,2047,169,-1878,0,0,0
3915536,Mike Weber,RB,2048,169,-1879,0,0,0
16020,Spencer Ware,RB,2049,169,-1880,0,0,0
3884368,James Williams,RB,2050,169,-1881,0,0,0
14099,Luke Stocker,TE,2051,169,-1882,0,0,0
3059766,Deon Yelder,TE,2052,169,-1883,0,0,0
14135,Anthony Sherman,RB,2053,169,-1884,0,0,0
16995,Bennie Fowler,WR,2054,169,-1885,0,0,0
15653,Jamize Olawale,RB,2055,169,-1886,0,0,0
4035222,Trayveon Williams,RB,2056,169,-1887,0,0,0
2577189,Brett Hundley,QB,2057,169,-1888,0,0,0
14100,Dwayne Harris,WR,2058,169,-1889,0,0,0
3059989,Nick Mullens,QB,2059,169,-1890,0,0,0
16724,Blake Bortles,QB,2060,169,-1891,0,0,0
3699935,Devine Ozigbo,RB,2061,169,-1892,0,0,0
16786,Richard Rodgers,TE,2062,169,-1893,0,0,0
2511109,Trevor Siemian,QB,2063,169,-1894,0,0,0
16140,Ryan Griffin,QB,2064,169,-1895,0,0,0
2517017,Sean Mannion,QB,2065,169,-1896,0,0,0
3929927,Karan Higdon,RB,2066,169,-1897,0,0,0
3042876,Ryan Finley,QB,2067,169,-1898,0,0,0
15921,Kenjon Barner,RB,2068,169,-1899,0,0,0
2576336,Ameer Abdullah,RB,2069,169,-1900,0,0,0
3919104,Kerrith Whyte,RB,2088,169,-1919,0,0,0
3128317,Juwann Winfree,WR,2093,169,-1924,0,0,0
3134314,Austin Roberts,TE,2094,169,-1925,0,0,0
3924318,Emanuel Hall,WR,2097,169,-1928,0,0,0
3932433,Alize Mack,TE,2098,169,-1929,0,0,0
4035014,Isaac Nauta,TE,2099,169,-1930,0,0,0
3139591,Quinton Flowers,RB,2100,169,-1931,0,0,0
3722362,Brett Rypien,QB,2101,169,-1932,0,0,0
3921970,Sutton Smith,RB,2105,169,-1936,0,0,0
3915381,John Kelly,RB,2106,169,-1937,0,0,0
4038938,Dillon Mitchell,WR,2107,169,-1938,0,0,0
3929855,Chris Warren,RB,2109,169,-1940,0,0,0
3124964,Marcus Green,WR,2110,169,-1941,0,0,0
3932420,Josh Adams,RB,2111,169,-1942,0,0,0
3705353,Rodney Anderson,RB,2112,169,-1943,0,0,0
3932936,Caleb Wilson,TE,2118,169,-1949,0,0,0
4035006,Elijah Holyfield,RB,2119,169,-1950,0,0,0
3115315,Duke Williams,WR,2121,169,-1952,0,0,0
3116144,Clayton Thorson,QB,2123,169,-1954,0,0,0
3116172,Trace McSorley,QB,2124,169,-1955,0,0,0
4037235,Greg Dortch,WR,2125,169,-1956,0,0,0
3048680,Taquan Mizzell,RB,2126,169,-1957,0,0,0
3052662,Keith Ford,RB,2128,169,-1959,0,0,0
3042435,Kevin White,WR,2130,169,-1961,0,0,0
3051857,J'Mon Moore,WR,2131,169,-1962,0,0,0
3045164,Jester Weah,WR,2132,169,-1963,0,0,0
2972092,Kyle Sloter,QB,2135,169,-1966,0,0,0
13484,Joe Webb,QB,2139,169,-1970,0,0,0
17421,Senorise Perry,RB,2141,169,-1972,0,0,0
16809,Garrett Gilbert,QB,2143,169,-1974,0,0,0
2513030,Geremy Davis,WR,2144,169,-1975,0,0,0
8416,Alex Smith,QB,2145,169,-1976,0,0,0
16227,Russell Shepard,WR,2149,169,-1980,0,0,0
16252,Tyler Bray,QB,2150,169,-1981,0,0,0
2521161,Zach Zenner,RB,2151,169,-1982,0,0,0
16763,Jordan Matthews,TE,2154,169,-1985,0,0,0
2591718,Marken Michel,WR,2157,169,-1988,0,0,0
2512197,Rod Smith,RB,2160,169,-1991,0,0,0
3843217,Chandler Cox,RB,2164,169,-1995,0,0,0
3930901,Bruce Anderson,RB,2167,169,-1998,0,0,0
3932442,Equanimeous St. Brown,WR,2168,169,-1999,0,0,0
3916925,Kerryon Johnson,RB,2169,169,-2000,0,0,0
4034949,Eddy Pineiro,K,2170,169,-2001,0,0,0
3931398,Bryce Love,RB,2171,169,-2002,0,0,0
4212909,David Moore,WR,2172,169,-2003,0,0,0
4261020,Trenton Cannon,RB,2173,169,-2004,0,0,0
3915115,Jordan Scarlett,RB,2174,169,-2005,0,0,0
3932449,Dexter Williams,RB,2175,169,-2006,0,0,0
4035015,Riley Ridley,WR,2176,169,-2007,0,0,0
3916071,Gary Jennings,WR,2177,169,-2008,0,0,0
3123944,Qadree Ollison,RB,2178,171,-2007,0,0,0
3915097,Antonio Callaway,WR,2179,169,-2010,0,0,0
3917940,Hakeem Butler,TE,2180,169,-2011,0,0,0
4361606,Darwin Thompson,RB,2181,169,-2012,0,0,0
3923397,Ryquell Armstead,RB,2182,169,-2013,0,0,0
3915823,Keke Coutee,WR,2183,170,-2013,0,0,0
3127306,Dante Pettis,WR,2184,169,-2015,0,0,0
3115913,Geronimo Allison,WR,2185,169,-2016,0,0,0
3116721,Jaylen Samuels,RB,2187,170,-2017,0,0,0
3052413,Matthew McCrane,K,2189,169,-2020,0,0,0
3125116,D'Onta Foreman,RB,2190,169,-2021,0,0,0
3059918,Rodney Adams,WR,2191,169,-2022,0,0,0
3054845,Robert Foster,WR,2192,169,-2023,0,0,0
3060022,Jordan Howard,RB,2193,169,-2024,0,0,0
3115365,Trey Quinn,WR,2195,169,-2026,0,0,0
3123052,Michael Badgley,K,2197,170,-2027,0,0,0
3123969,Ito Smith,RB,2198,169,-2029,0,0,0
3843750,Derrius Guice,RB,2199,169,-2030,0,0,0
3068939,Aldrick Rosas,K,2200,169,-2031,0,0,0
3042429,Wendell Smallwood,RB,2201,169,-2032,0,0,0
3043234,Zane Gonzalez,K,2202,169,-2033,0,0,0
3042494,Elijah McGuire,RB,2203,169,-2034,0,0,0
3047490,Janarion Grant,WR,2204,169,-2035,0,0,0
3040146,Akrum Wadley,RB,2205,169,-2036,0,0,0
2577253,Javorius Allen,RB,2206,169,-2037,0,0,0
2969962,Duke Johnson,RB,2207,169,-2038,0,0,0
2970038,David Grinnage,TE,2208,169,-2039,0,0,0
2977644,Todd Gurley II,RB,2209,169,-2040,0,0,0
2976516,T.J. Yeldon,RB,2210,169,-2041,0,0,0
2977609,Devin Funchess,WR,2211,169,-2042,0,0,0
16945,De'Anthony Thomas,WR,2214,169,-2045,0,0,0
17437,Taylor Gabriel,WR,2215,169,-2046,0,0,0
16821,David Fales,QB,2217,169,-2048,0,0,0
17082,Cody Parkey,K,2218,169,-2049,0,0,0
16880,TJ Jones,WR,2219,169,-2050,0,0,0
16944,Devonta Freeman,RB,2220,169,-2051,0,0,0
16974,Trey Burton,TE,2222,169,-2053,0,0,0
2573300,Jay Ajayi,RB,2223,169,-2054,0,0,0
16899,Quincy Enunwa,WR,2224,169,-2055,0,0,0
2576019,Josh Doctson,WR,2226,169,-2057,0,0,0
15825,Le'Veon Bell,RB,2232,169,-2063,0,0,0
16804,John Brown,WR,2234,170,-2064,0,0,0
15853,Vance McDonald,TE,2237,169,-2068,0,0,0
15860,Jordan Reed,TE,2238,169,-2069,0,0,0
16040,C.J. Anderson,RB,2241,169,-2072,0,0,0
16486,Brett Maher,K,2244,169,-2075,0,0,0
16730,Kelvin Benjamin,TE,2245,169,-2076,0,0,0
15788,Tyler Eifert,TE,2246,169,-2077,0,0,0
15994,Theo Riddick,RB,2247,169,-2078,0,0,0
16781,Paul Richardson Jr.,WR,2248,169,-2079,0,0,0
16787,Marqise Lee,WR,2249,169,-2080,0,0,0
16791,Donte Moncrief,WR,2250,169,-2081,0,0,0
16016,Kenny Stills,WR,2251,169,-2082,0,0,0
15966,Chris Thompson,RB,2252,169,-2083,0,0,0
14875,Robert Griffin III,QB,2253,169,-2084,0,0,0
14886,Lamar Miller,RB,2254,169,-2085,0,0,0
14198,Dion Lewis,RB,2257,169,-2088,0,0,0
14322,Dan Bailey,K,2258,169,-2089,0,0,0
14894,Robert Turbin,RB,2259,169,-2090,0,0,0
13216,Demaryius Thomas,WR,2262,169,-2093,0,0,0
14269,Dontrelle Inman,WR,2263,169,-2094,0,0,0
13994,Cam Newton,QB,2266,169,-2097,0,0,0
14816,Kai Forbath,K,2267,169,-2098,0,0,0
14007,Lance Kendricks,TE,2268,169,-2099,0,0,0
14912,Alshon Jeffery,WR,2272,169,-2103,0,0,0
14083,Bruce Miller,RB,2273,169,-2104,0,0,0
14129,Bilal Powell,RB,2274,169,-2105,0,0,0
15009,Alfred Morris,RB,2275,169,-2106,0,0,0
15062,Travis Benjamin,WR,2276,169,-2107,0,0,0
13217,Golden Tate,WR,2277,169,-2108,0,0,0
13215,Dez Bryant,WR,2278,169,-2109,0,0,0
15091,Randy Bullock,K,2279,170,-2109,0,0,0
10453,Ted Ginn Jr.,WR,2281,169,-2112,0,0,0
12563,Michael Crabtree,WR,2283,169,-2114,0,0,0
10452,Adrian Peterson,RB,2284,169,-2115,0,0,0
10456,Marshawn Lynch,RB,2285,169,-2116,0,0,0
1097,Adam Vinatieri,K,2286,169,-2117,0,0,0
10475,Greg Olsen,TE,2287,169,-2118,0,0,0
2580,Drew Brees,QB,2288,169,-2119,0,0,0
3609,Josh McCown,QB,2289,169,-2120,0,0,0
10621,Nick Folk,K,2290,170,-2120,0,0,0
4333,Matt Bryant,K,2291,169,-2122,0,0,0
11128,Matt Moore,QB,2292,169,-2123,0,0,0
5526,Eli Manning,QB,2293,169,-2124,0,0,0
5528,Larry Fitzgerald,WR,2294,169,-2125,0,0,0
5529,Philip Rivers,QB,2295,169,-2126,0,0,0
5557,Ben Watson,TE,2296,169,-2127,0,0,0
11394,Josh Johnson,QB,2298,169,-2129,0,0,0
11674,Danny Amendola,WR,2300,169,-2131,0,0,0
8461,Mike Nugent,K,2301,169,-2132,0,0,0
11923,Stephen Hauschka,K,2302,169,-2133,0,0,0
8479,Frank Gore,RB,2303,169,-2134,0,0,0
8544,Darren Sproles,RB,2304,169,-2135,0,0,0
12514,LeSean McCoy,RB,2305,169,-2136,0,0,0
12649,Julian Edelman,WR,2306,169,-2137,0,0,0
9704,Stephen Gostkowski,K,2307,169,-2138,0,0,0
9761,Delanie Walker,TE,2309,169,-2140,0,0,0
3087801,Nick Fitzgerald,QB,2310,169,-2141,0,0,0
3917546,Penny Hart,WR,2311,169,-2142,0,0,0
3123074,Tyre Brady,WR,2312,169,-2143,0,0,0
3915575,Kelvin McKnight,WR,2313,169,-2144,0,0,0
3886636,Alex Barnes,RB,2316,169,-2147,0,0,0
4049301,Anthony Johnson,WR,2318,169,-2149,0,0,0
3915230,C.J. Conrad,TE,2319,169,-2150,0,0,0
3119471,Emmanuel Butler,WR,2320,169,-2151,0,0,0
4035102,Damarea Crockett,RB,2321,169,-2152,0,0,0
4241723,Damion Willis,WR,2323,169,-2154,0,0,0
3116642,Reggie Bonnafon,RB,2324,169,-2155,0,0,0
3120980,Keelan Doss,WR,2325,169,-2156,0,0,0
4420894,Christian Wade,RB,2326,169,-2157,0,0,0
3843603,Jazz Ferguson,WR,2327,169,-2158,0,0,0
3917960,Steven Sims,WR,2328,169,-2159,0,0,0
3052449,Dalyn Dawkins,RB,2329,169,-2160,0,0,0
3120588,Darrius Shepherd,WR,2330,169,-2161,0,0,0
3127211,Patrick Laird,RB,2331,169,-2162,0,0,0
3127051,Devlin Hodges,QB,2345,169,-2176,0,0,0
4249496,Alexander Hollins,WR,2346,169,-2177,0,0,0
3925348,Hale Hentges,TE,2347,169,-2178,0,0,0
3047504,Andre Patton,WR,2348,169,-2179,0,0,0
3039968,Ishmael Hyman,WR,2349,169,-2180,0,0,0
3050481,Tanner Hudson,TE,2350,169,-2181,0,0,0
4048717,Rico Gafford,WR,2351,169,-2182,0,0,0
2971397,Fred Brown,WR,2352,169,-2183,0,0,0
3122103,Kendall Blanton,TE,2362,169,-2193,0,0,0
3126075,Spencer Schnell,WR,2366,169,-2197,0,0,0
3951441,Codey McElroy,TE,2369,169,-2200,0,0,0
4069806,Jason Moore,WR,2371,169,-2202,0,0,0
4217370,Cyril Grayson,WR,2377,169,-2208,0,0,0
3060919,Wes Hills,RB,2379,169,-2210,0,0,0
3126263,Charles Jones,TE,2380,169,-2211,0,0,0
3138760,Ventell Bryant,WR,2381,169,-2212,0,0,0
3057863,Jason Vander Laan,TE,2386,169,-2217,0,0,0
3127335,Ryan Nall,RB,2387,169,-2218,0,0,0
3115443,Cody Hollister,WR,2388,169,-2219,0,0,0
3043225,Steven Mitchell Jr.,WR,2391,169,-2222,0,0,0
15284,Bradley Sowell,TE,2394,169,-2225,0,0,0
2586703,Tevin Jones,WR,2396,169,-2227,0,0,0
3116384,Carson Meier,TE,2398,169,-2229,0,0,0
4421446,Craig Reynolds,RB,2401,169,-2232,0,0,0
3123857,Austin Walter,RB,2405,169,-2236,0,0,0
3053732,Jordan Chunn,RB,2407,169,-2238,0,0,0
3886841,Tony Brooks-James,RB,2409,169,-2240,0,0,0
3122799,Jonathan Hilliman,RB,2411,169,-2242,0,0,0
3049329,Rashard Davis,WR,2419,169,-2250,0,0,0
4035496,John Franklin,WR,2420,169,-2251,0,0,0
3931391,Trenton Irwin,WR,2422,169,-2253,0,0,0
3124084,Joey Slye,K,2423,170,-2253,0,0,0
4029893,Antonio Gandy-Golden,WR,2424,169,-2255,0,0,0
4239083,Michael Warren II,RB,2425,169,-2256,0,0,0
4040790,Jason Huntley,RB,2426,169,-2257,0,0,0
4038994,Sam Sloman,K,2427,169,-2258,0,0,0
3913295,Justin Rohrwasser,K,2428,169,-2259,0,0,0
4037591,Joe Reed,WR,2434,169,-2265,0,0,0
3914395,James Morgan,QB,2435,169,-2266,0,0,0
4038220,Cole McDonald,QB,2436,169,-2267,0,0,0
4373673,John Hightower,WR,2437,169,-2268,0,0,0
4034964,Tyrie Cleveland,WR,2445,169,-2276,0,0,0
4035426,Stephen Sullivan,TE,2446,169,-2277,0,0,0
3791110,Tommy Stevens,TE,2448,169,-2279,0,0,0
4248504,Isaiah Coulter,WR,2449,169,-2280,0,0,0
3895785,Ben DiNucci,QB,2450,169,-2281,0,0,0
4240689,Jake Fromm,QB,2452,169,-2283,0,0,0
4242540,Isaiah Hodgins,WR,2453,169,-2284,0,0,0
3914240,Tyler Davis,TE,2454,169,-2285,0,0,0
4036189,Thaddeus Moss,TE,2456,169,-2287,0,0,0
3916927,Will Hastings,WR,2457,169,-2288,0,0,0
2974503,Reggie Begelton,WR,2458,169,-2289,0,0,0
3915145,Kirk Merritt,WR,2459,169,-2290,0,0,0
4240626,Jeff Thomas,WR,2460,169,-2291,0,0,0
4038533,Darius Anderson,RB,2461,169,-2292,0,0,0
4055171,Anthony Gordon,QB,2462,169,-2293,0,0,0
3915772,Jared Pinkney,TE,2463,169,-2294,0,0,0
3917166,Omar Bayless,WR,2464,169,-2295,0,0,0
4241940,Javon Leake,RB,2465,169,-2296,0,0,0
4044121,Isaiah Wright,WR,2466,169,-2297,0,0,0
3930298,Noah Togiai,TE,2467,169,-2298,0,0,0
4046715,Trishton Jackson,WR,2468,169,-2299,0,0,0
4329472,Nick Keizer,TE,2469,169,-2300,0,0,0
3051387,Marcus Baugh,TE,2470,169,-2301,0,0,0
3917812,Nathan Cottrell,RB,2472,169,-2303,0,0,0
3118906,John Lovett,RB,2476,169,-2307,0,0,0
3125999,Nate Becker,TE,2485,169,-2316,0,0,0
3116074,Rodney Smith,RB,2486,169,-2317,0,0,0
4374496,DeMichael Harris,WR,2487,169,-2318,0,0,0
4040629,Antonio Williams,RB,2488,169,-2319,0,0,0
4042808,Artavis Pierce,RB,2489,169,-2320,0,0,0
4052137,Chris Rowland,WR,2490,169,-2321,0,0,0
3917849,Lawrence Cager,WR,2491,169,-2322,0,0,0
3049290,Kevin Rader,TE,2492,169,-2323,0,0,0
3121378,Matt Sokol,TE,2493,169,-2324,0,0,0
3917558,Brandon Wright,K,2498,169,-2329,0,0,0
3917569,Ja'Marcus Bradley,WR,2499,169,-2330,0,0,0
3700815,Kendall Hinton,WR,2501,169,-2332,0,0,0
3138744,Chris Myarick,TE,2504,169,-2335,0,0,0
3915821,Tony Brown,WR,2506,169,-2337,0,0,0
17480,Sergio Castillo,K,2508,169,-2339,0,0,0
4041703,Matt Cole,WR,2510,169,-2341,0,0,0
3048898,Elliott Fry,K,2513,169,-2344,0,0,0
3910176,Kristian Wilkerson,WR,2516,169,-2347,0,0,0
3895835,Jake Bargas,RB,2517,169,-2348,0,0,0
3930097,Farrod Green,TE,2518,169,-2349,0,0,0
3916129,Isaiah Zuber,WR,2519,169,-2350,0,0,0
4040640,Darius Bradwell,RB,2520,169,-2351,0,0,0
4611153,Taylor Russolino,K,2521,169,-2352,0,0,0
3128444,Matthew Wright,K,2524,169,-2355,0,0,0
3115359,Daniel Helm,TE,2525,169,-2356,0,0,0
3914534,Jeremy Cox,RB,2527,169,-2358,0,0,0
3919510,Alex Bachman,WR,2528,169,-2359,0,0,0
3135726,Jon Brown,K,2529,169,-2360,0,0,0
3053760,Jeff Badet,WR,2530,169,-2361,0,0,0
3040499,Johnny Stanton,RB,2531,169,-2362,0,0,0
4035098,Tucker McCann,K,2568,169,-2399,0,0,0
4360802,Javian Hawkins,RB,2569,169,-2400,0,0,0
4036026,Dez Fitzpatrick,WR,2571,169,-2402,0,0,0
4035465,Cornell Powell,WR,2572,169,-2403,0,0,0
4240661,Dazz Newsome,WR,2573,169,-2404,0,0,0
4258190,Ben Mason,RB,2574,169,-2405,0,0,0
4371974,Seth Williams,WR,2575,169,-2406,0,0,0
4068152,Kawaan Baker,WR,2578,169,-2409,0,0,0
4047648,Tre Nixon,WR,2580,169,-2411,0,0,0
4240432,Sage Surratt,WR,2582,169,-2413,0,0,0
4746079,Zach Davidson,TE,2584,169,-2415,0,0,0
4037311,Jalen Camp,WR,2586,169,-2417,0,0,0
4037478,Gerrid Doaks,RB,2587,169,-2418,0,0,0
13200,Tim Tebow,TE,2589,169,-2420,0,0,0
4031033,Cade Johnson,WR,2590,169,-2421,0,0,0
4044144,Kenny Yeboah,TE,2591,169,-2422,0,0,0
4039253,Trevon Wesco,TE,1152,169,-983,0,0,0
